00000000100
00000005000
10010010000
00010300000
00001000000
00010000000
00000000000
