00101000000
01000011100
01000000001
10010110005
10000107010
00000010150
01007205020
