00007001101
00000000000
00010000001
00136000000
00000010010
40000000500
00000170000
