00000000000
00010700007
00000004000
00101000400
00100000000
00000001012
01100101000
