00000000100
10000000000
01000000000
00000000000
00000000000
00000000000
00000000004
