07300001011
00101000000
00001000001
00000600000
10000000601
00000000001
00001010201
