10000000000
00010016001
01010000000
00000010000
10040000000
00000000007
00100000000
