10010011051
00011010010
00101004010
01116000150
00000000040
00100001011
01111000000
