00100100010
10000100006
00000001000
00000001001
00010000010
01010000050
10101001100
