00110000010
00000000000
00000000010
00000050000
01000000000
00000000000
00010060000
