00000000000
10010000300
10010100000
00100201003
00010000000
00000000000
40000010110
