00300000000
00000006000
50100050000
00000200050
20000000030
10101000000
00000100100
