50000000002
00104120001
01010010000
60000000000
00000000030
00010700000
10010000000
