00000107100
00000010015
10006000010
10020000013
60100010110
00114040010
10070700000
