00100000001
01000000010
01300010011
00000000000
00000400005
10710000070
11001000000
