00100000000
10000010000
01110110110
01017000000
01010000101
00040000000
11000121005
