01100010100
01010100000
00000000000
10010001000
00210002001
00100012105
00000000001
