00000000010
00100050000
00006100010
00010100000
00001000010
10001000000
10100010002
