00011001000
01001000700
00012000000
06100000000
00000000100
10010023000
51001100010
