01000001001
00100000000
00101001404
00300101040
00000100000
00000000010
01000100010
