00010010000
00010000110
00010000000
01000100000
00000010000
00000000000
00000000000
