00000001000
00000001000
10000050001
11000010010
00000000000
00001000000
00000103020
