00000010001
40001100011
01063010000
01010011001
10000000000
50001011000
01000000000
