03001000010
01000011000
00000030000
00010000010
01000010000
01110000000
10006000010
