00200005000
01006000000
01000100010
00001101001
00000110011
10001000150
00000010100
