00000000000
00000001000
30010000100
00010000150
11101000000
40040000010
01001000100
