10005100001
00000110161
01000100000
01000007001
00050000500
00010010001
00000000001
