00100000000
00110000100
00010000030
00000000000
00000000010
00060020000
51000001000
