00006000000
00000301001
00000000000
10400000000
00000700010
00001000101
00000000000
