11100140101
00110110100
11000101010
00003010001
00000001110
00000000610
01000000001
