00010000000
00000100000
00000102010
00050200001
00000011000
00370100101
70000010000
