60000500100
00001000000
00001000000
00030050000
01000005000
00100000000
00001000000
