30050000000
00000010300
00000000010
00001010601
01110000000
01300000000
04710000060
