10300011300
00001110000
00000000000
00010000000
00000141400
00000000004
01000000000
