02010010000
00001001411
00320000010
01000010000
00070015010
01000100000
10001000000
