00010000000
00001501160
00000000000
00000000000
00000005000
00100001110
01004044000
