00000000105
00002000140
00100000410
00010041100
00710010001
00001000001
01010101011
