33000000050
00100016000
00001051000
10006100111
00110100000
10000100011
00000000000
