00501000000
10010014001
01000000310
00000000300
10101000000
00001000000
00000010700
