01000010500
00000001500
10001000000
00001000600
05005000000
00600000000
00003001014
