00000030010
10000002000
01001000000
00000000710
00000100110
05000000000
01000000000
