00000710704
00001600010
00100000000
01010001001
00000000001
00000000001
10101000150
