00000000006
00000100100
00000110001
40000300150
00000000110
61001003400
00000200000
