02016011043
01000000000
00760100000
10000000000
00001001000
04100002000
00010100010
