00000000000
71110060000
00004010000
47000111000
01060010102
07011000000
01000010006
