02000000010
00005004002
00001000017
11000010101
00001000100
00010001010
00000000700
